Groups of people observe fish in a large tank .	Menschengruppe beobachten Fische in einem großen Becken .
Four people walking across thick snow during a sunset .	Vier Personen , die bei Sonnenuntergang durch dicken Schnee waten .
A waiter presenting an order to the kitchen staff .	Ein Kellner , der Küchenpersonal eine Bestellung überbringt .
A woman in a teal shirt and a beige cardigan looks away from the board game she is sitting in front of .	Eine Frau in einem türkisen Oberteil und einer beigefarbenen Strickjacke blickt von einem Brettspiel auf , vor dem sie sitzt .
People waiting in line for their favorite beverage .	Leute warten in einer Schlange auf ihr Lieblingsgetränk .
A military or police officer stands by as people pass in a public square .	Ein Militärangehöriger oder Polizist steht in einem Park , während Menschen an ihm vorbeigehen .
A woman in a red dress covers another woman 's eyes .	Eine Frau in einem roten Kleid bedeckt die Augen einer anderen Frau .
A woman reading a newspaper and a man in a green jacket riding a train .	Eine zeitungslesende Frau und ein Mann in einer grünen Jacke fahren Zug .
A man standing and cheering amongst a stadium of others sitting .	Ein Mann , der in einem Stadium zwischen sitzenden Personen steht und jemand anfeuert .
A man without a shirt is walking on top of lots of rocks .	Ein Mann mit nacktem Oberkörper geht auf vielen Steinen .
A boy in a red sweater running on the beach	Ein Junge in einem roten Pullover , der am Strand rennt .
A couple walking at a gathering with a balloon in the air behind them .	Ein Paar , das bei einer Zusammenkunft mit einem Luftballon unterwegs ist , der hinter ihm in der Luft schwebt .
A man in a black hat walks down the street .	Ein Mann mit schwarzem Hut geht die Straße entlang .
A man is standing on a street holding a sign .	Ein Mann steht auf einer Straße und hält ein Schild .
The man on the beach looking for stuff with metal detector .	Der Mann am Strand , der mit einem Metalldetektor nach Sachen sucht .
A young boy wearing a blue t @-@ shirt holds up an odd @-@ looking object for inspection while standing among trees .	Ein Junge mit einem blauen T @-@ Shirt steht zwischen Bäumen und hält ein komisch aussehendes Objekt zur Begutachtung hoch .
Two young children are standing in hall .	Zwei kleine Kinder stehen in einem Flur .
The waterskier does a flip behind a boat .	Das Wasserskifahrer macht hinter einem Boot einen Salto .
A small boy is sitting on a bench next to a large jelly bean mascot .	Ein kleiner Junge sitzt auf einer Bank neben einem großen Geleebonbon @-@ Maskottchen .
Two people are wakeboarding in the water and are being pulled by a boat .	Zwei Leute machen Wakeboarding im Wasser und werden von einem Boot gezogen .
A man sprinkles seasonings on his barbecue in front of foliage .	Ein Mann streut Gewürze auf sein Grillgut , im Hintergrund ist Laub zu sehen .
Boy with dark skin , standing on his head with legs spread , at the end of a floating wooden boat .	Ein Junge mit dunkler Haut , der am Ende eines schwimmenden Holzboots mit gespreizten Beinen auf dem Kopf steht .
Two men are playing music on a bench .	Zwei Männer auf einer Bank musizieren .
Two woman in colorful costumes look at a little girl wearing a brown vest .	Zwei Frauen in farbenfrohen Kostümen blicken auf ein Mädchen mit einem braunen Oberteil .
Some children watching fish in a pool .	Ein paar Kinder beobachten Fische in einem Becken .
A backhoe is on top of a pile of rubble from a demolished building .	Ein Bagger steht auf einem Schutzhaufen vor einem abgerissenen Gebäude .
Three boys play with paddles on the beach .	Drei Jungen spielen am Strand mit Paddeln .
A woman in a light blue jacket is riding a bike .	Eine Frau in einer hellblauen Jacke fährt Fahrrad .
Someone is taking a stroll on their bike .	Jemand macht einen Ausflug mit dem Fahrrad .
Two people with helmets are riding bikes in front of a building .	Zwei Personen mit Schutzhelmen fahren vor einem Gebäude Fahrrad .
Two bicyclists riding beside some railroad tracks .	Zwei Fahrradfahrer fahren neben Eisenbahnschienen entlang .
A couple enjoy a beautiful day bicycling on a bike trail wearing bicycling safety helmets and gloves .	Ein Paar , das beim Fahrradfahren auf einem Radweg Fahrradhelme und Handschuhe trägt , genießt einen schönen Tag .
Women in bike helmets take break from long ride .	Frauen mit Fahrradhelmen machen nach langer Fahrt eine Pause .
A man wearing a black helmet , blue jacket , and khaki shirts rides his bike on the street next to a red car .	Ein Mann mit Fahrradhelm , blauer Jacke und khakifarbenen Hosen fährt mit seinem Fahrrad auf der Straße neben einem roten Auto .
Kid about to go on bike ride with parent	Ein Kind , das gleich mit einem seiner Eltern Fahrrad fahren wird .
Two little boys look back as they walk across a grassy area .	Zwei Jungen , die durch Gras gehen , blicken zurück .
Child on a small motorbike near a small pond .	Ein Kind auf einem kleinen Motorrad in der Nähe eines kleinen Teichs .
Two little blond girls in helmets are sitting on a red ATV .	Zwei kleine blonde Mädchen mit Helmen sitzen auf einem roten Geländewagen .
A boy in white plays baseball .	Ein weiß gekleideter Junge spielt Baseball .
A young boy with his tongue stuck out is climbing onto a wooden platform .	Ein Junge klettern mit herausgestreckter Zunge auf eine Holzplattform .
A woman standing at the counter of a takeout window .	Eine Frau steht am Fenster eines Imbissfensters .
A dog wearing a blue harness stands in the snow and pants .	Ein Hund mit einem blauen Geschirr steht im Schnee und hechelt .
A woman is standing next to a Japanese version of Disney 's Snow White .	Eine Frau steht neben einer japanischen Version von Walt Disney ' s Schneewittchen .
A woman orders a dish at a street kitchen vendor .	Eine Frau bestellt bei einem Straßenküchenverkäufer ein Gericht .
Dogs pulling a sled in a sled race .	Bei einem Hunderennen ziehen Hunde einen Schlitten .
A lone musician in black is on stage , playing an acoustic guitar and singing into a microphone .	Ein einzelner Musiker in Schwarz ist auf der Bühne , spielt akustische Gitarre und singt in ein Mikrofon .
A young boy in a swimming suit sits in water .	Ein Junge im Schwimmanzug sitzt im Wasser .
A woman in jeans walking along a pathway with green railing .	Eine Frau in Jeans , die auf einem Pfad mit einem grünen Geländer geht .
A woman in a black shirt is hugging a man .	Eine Frau mit einem schwarzen Oberteil umarmt einen Mann .
A woman squatting in the grass is smiling at a little boy , as he smiles and raises his hands in the air .	Eine Frau , die im Gras in der Hocke sitzt , lächelt einen kleinen Jungen an , der selbst lächelt und seine Hände hoch hebt .
The dog has red straps in its back .	Der Hund hat rote Riemen auf seinem Rücken .
A black dog and a white dog are standing on snow .	Ein schwarzer Hund und ein weißer Hund stehen im Schnee .
A dog jumping in the water at a beack .	Ein Hund springt an einer Bake ins Wasser .
A brown , fluffy dog jumping into a swimming pool after a red toy .	Ein brauner , flauschiger Hund , der einem roten Spielzeug in den Pool nachspringt .
A white dog jumping to catch a red ball .	Ein weißer Hund , der springt , um einen roten Ball zu fangen .
A boy jumps from one table to another at a park .	Ein Junge springt in einem Park von einem Tisch auf einen anderen .
Two and four footed neighbors stop by to visit .	Zwei- und vierbeinige Nachbarn kommen auf einen Besuch vorbei .
A heavyset couple interact outside a striped cabana on a beach located near a pier .	Ein beleibtes Paar ist vor einem gestreiften Umkleidezelt an einem Strand in der Nähe eines Piers miteinander beschäftigt .
A young girl tries her hand at gardening .	Ein Mädchen versucht sich als Gärtnerin .
A lady that 's holding a yellow bag is sitting on a chair in a store .	Eine Dame , die eine gelbe Tasche hält , sitzt in einem Laden auf einem Stuhl .
A woman reaching out to lights .	Eine Frau , die nach Streichhölzern greift .
Three young women perform a dance in a crowded hall .	Drei Frauen , die in einem vollen Saal einen Tanz vorführen .
There are three swimmers from the same team getting ready to compete .	Drei Schwimmer , die zum gleichen Team gehören , bereiten sich auf den Wettkampf vor .
Two people are swimming in water next to a red buoy .	Zwei Personen schwimmen neben einer roten Boje .
Two boys stand beside a pile of garbage on the ground .	Zwei Jungen stehen neben einem Haufen Müll auf dem Boden .
A little boy is holding a green and yellow sponge while standing in front of a stove .	Ein kleiner Junge steht vor einem Herd und hält einen grün @-@ gelben Schwamm .
A woman squatting to face a small child while holding a dog .	Eine Frau , die in der Hocke sitzt , um auf Augenhöhe mit einem Kleinkind zu sein , und gleichzeitig einen Hund hält .
A man standing in a hole in front of a woman in a garden .	Ein Mann , der in einem Garten in einem Loch vor einer Frau steht .
A worker in a blue hat is fixing the wall .	Ein Arbeiter mit blauem Schutzhelm repariert die Mauer .
A woman in traditional Islamic garb walks through a plaza with a bearded man .	Eine Frau in traditioneller islamischer Kleidung geht mit einem bärtigen Mann durch ein Einkaufszentrum .
A family poses for a photo at dinner .	Eine Familie posiert beim Abendessen für ein Foto .
A woman talks animatedly to her companion next to a body of water .	Neben einem Gewässer spricht eine Frau angeregt mit ihrem Begleiter .
Man with hat juggling in front of a captivated audience .	Ein Mann mit Hut , der vor einem faszinierten Publikum jongliert .
A man on a phone and woman sitting near a painting .	Ein Mann am Telefon und eine Frau , die in der Nähe eines Gemäldes sitzen .
A woman holding a dog on a leash .	Eine Frau , die einen Hund an der Leine hält .
A person is setting at a table in a cafe .	Eine Person , die in einem Café an einem Tisch sitzt .
A woman is drinking from a green straw .	Eine Frau , die mit einem grünen Strohhalm trinkt .
A gentleman in a purple scarf and hat is looking at money while holding an accordion .	Ein Herr mit violettem Schal und Hut hält ein Akkordeon und blickt auf Geld .
A lady in a red and black striped shirt is sitting on a retaining wall .	Eine Frau in einem rot @-@ schwarz @-@ gestreiften Oberteil sitzt auf einer Stützmauer .
A crowd of people are standing together on a sidewalk , while one man is taking a picture .	Eine Menschenmenge steht auf einem Bürgerteig , während ein Mann fotografiert .
The woman in glasses is holding a red and white sale bag .	Eine Frau mit Brille hält eine rot @-@ weiße Einkaufstüte .
Four boys run down a stone paved sidewalk .	Vier Jungen rennen einen gepflasterten Bürgersteig entlang .
A female looking out the window as a male looks in .	Eine weibliche Person , die aus dem Fenster blickt , während eine männliche Person hinein blickt .
A hiker with an American flag on his backpack walks through the woods .	Ein Wanderer mit einer amerikanischen Flagge auf seinem Rucksack wandert durch den Wald .
A man in a red shirt sits at a table with a glass of water .	Ein Mann mit einem roten Hemd sitzt mit einem Glas Wasser an einem Tisch .
A man cooking something in an old fire burning oven with a apron on .	Ein Mann mit einer Schürze , der etwas in einem alten Holzofen zubereitet .
These people are cooking lots of food .	Diese Leute kochen jede Menge Essen .
A little girl in a sweater is swung around by an unseen hand .	Ein kleines Mädchen in einem Pullover wird von einer nicht sichtbaren Hand herumgedreht .
A man in a jumpsuit and hat tends to a large spool of rope .	Ein Mann mit Overall und Helm kümmert sich um eine große Seilrolle .
A boy in swim trunks does a backflip into the ocean while mountains show through the fog behind him .	Ein Junge in Badehosen macht eine Rolle rückwärts ins Meer , hinter ihm sind durch den Nebel Berge zu sehen .
An injured , bloody person sitting with friends in a hospital waiting room .	Eine verletzte , blutende Person sitzt mit Freunden im Warteraum eines Krankenhauses .
Six shirtless men are standing outside leaning on or standing near a fence .	Sechs Männer mit nacktem Oberkörper stehen im Freien und lehnen sich an einen Zaun oder stehen neben dem Zaun .
A painter shows off his talent in front of a group of people	Ein Maler zeigt sein Talent vor einer Menschenansammlung .
A boy is holding his nose and jumping off a diving board backwards into a lake .	Ein Junge hält seien Nase zu und springt von einem Sprungbrett aus rückwärts in einen See .
A young boy pulls a car toy up a hill .	Ein kleiner Junge zieht ein Spielzeugauto einen Hügel hinauf .
An Asian woman in a red sweater holding her baby .	Eine asiatische Frau in rotem Pullover , die ihr Baby hält .
A asian man gives an evil eye to the camera .	Ein asiatischer Mann , der mit bösem Blick in die Kamera sieht .
A toddler wearing a onesie is stretching to see a video game in an arcade .	Ein Kleinkind in einem Einteiler streckt sich , um ein Videospiel in einer Einkaufspassage zu sehen .
A young boy laying face down in water .	Ein Junge , der mit dem Gesicht nach unten im Wasser liegt .
Three boys in size order getting wet next to a wall	Drei der Größe nach angeordnete Jungen neben einer Mauer , die nass werden .
A woman with braids is kneeling down and adjusting string on a machine	Eine Frau mit Zöpfen kniet und stellt an einer Maschine eine Schnur ein .
Two people with yellow backpacks hiking up a hill .	Zwei Leute mit gelben Rucksäcken , die einen Hügel hinauf wandern .
In a tree filled park a man stretches .	In einem Park mit vielen Bäumen streckt sich ein Mann .
Various passengers on a bus look out the window or into the distance .	Mehrere Passagiere eines Busses blicken aus dem Fenster in die Ferne .
Two male security officers are restraining another man by the shoulders and arms .	Zwei männliche Security @-@ Mitarbeiter halten einen anderen Mann an Schultern und Armen fest .
Two hikers walk down an arid slope next to a green conifer .	Zwei Wanderer wandern neben einer grünen Konifere eine karge Böschung hinunter .
The boy has blond @-@ hair and a dirty face .	Der Junge hat blonde Haare und ein schmutziges Gesicht .
A woman looks stone @-@ faced in the mirror as she applies eyeliner .	Eine Frau blickt regungslos in den Spiegel , während sie Eyeliner aufträgt .
A few guys playing soccer on a field .	Ein paar Typen spielen auf einem Feld Fußball .
A man in a Hawaiian shirt is playing an orange electric guitar on a stage .	Ein Mann mit einem Hawaii @-@ Hemd spielt auf einer Bühne auf einer orangefarbenen Gitarre .
People on a crowded train or bus in Asia .	Leute in einem vollen Zug oder Bus in Asien .
There is a man on a bucking horse holding on tightly while the crowd watches at a rodeo .	Bei einem Rodeo hält sich ein Mann auf einem bockenden Pferd gut fest , während die Menge zusieht .
An adult man wearing jeans and black shirt holding a beverage .	Ein erwachsener Mann mit Jeans und schwarzem Hemd , der ein Getränk hält .
A man has his arms around two women who are posing for a picture with him .	Ein Mann hat seine Arme um zwei Frauen gelegt , die für ein Bild mit ihm posieren .
A mobile food station set up to serve patrons on the city streets .	Eine mobile Essensstation , die dazu dient , Stammgäste auf den Straßen der Stadt zu versorgen .
A woman with a red jacket and her companion eating snacks .	Eine Frau mit einer roten Jacke und ihr Begleiter , wie sie eine Kleinigkeit essen .
A very young boy sliding down a slide into a swimming pool , wearing blue floaties .	Ein ganz kleiner Junge mit blauen Schwimmflügeln , der über eine Rutsche in ein Schwimmbecken rutscht .
Girl with green tank top standing in the middle of a train track with multicolor train cars to the right .	Ein Mädchen mit grünem Pullunder , die in der Mitte eines Zuggleises steht , rechts mehrfarbige Zugwaggons .
Girl is standing out on the train tracks .	Ein Mädchen steht auf dem Gleis .
A fisherman is preparing his nets for his next haul .	Ein Fischer bereitet die Netze für seinen nächsten Fischzug vor .
A woman is sitting on a stool with an accordion .	Eine Frau sitzt mit einem Akkordeon auf einem Hocker .
Two gray dogs run through a field of pink heather .	Zwei graue Hunde rennen durch ein Feld mit rosa blühender Heide .
A young boy with swimming goggles , jumping into a swimming pool .	Ein Junge mit Schwimmbrille , der in ein Schwimmbecken springt .
People are working on the factory floor while yellow stacks of paper go by .	Menschen arbeiten in der Fertigung , während gelbe Papierstapel an ihnen vorbeitransportiert werden .
A young man , barefoot along side the beach , prunes a tree .	Ein junger Mann steht barfuß am Strand und schneidet einen Baum aus .
Two kids on wakeboards attempt to give one another a high @-@ five .	Zwei Kinder auf Wakeboards versuchen , einander ein High @-@ Five zu geben .
An outdoor cafe with people sitting while a man in white shirt is walking toward them .	Ein Cafe im Freien , in dem Leute sitzen , während ein Mann mit einem weißen Hemd auf sie zugeht .
There are many people with black hair heading through some doors and a few coming out .	Viele Leute mit schwarzen Haaren gehen durch ein paar Türen und wenige kommen heraus .
Several people walk up a staircase .	Mehrere Leute gehen eine Treppe hoch .
A man dressed in a burgundy shirt and black pants maneuvering a puppet which is holding a musical instrument .	Ein Mann in einem burgunderroten Hemd und schwarzen Hosen , der eine Marionette mit einem Musikinstrument bewegt .
The two racers drove the white bike down the road .	Die zwei Rennfahrer sind mit dem weißen Rad die Straße entlang gefahren .
Two boys , one in a red and one in a white uniform , fight for control over the ball during a soccer match .	Zwei Jungen , einer in einem roten und einer in einem weißen Dress , kämpfen bei einem Fußballspiel darum , wer die Kontrolle über den Ball gewinnt .
A man in a yellow vest sweeping a sidewalk .	Ein Mann in einer gelben Weste , der einen Gehweg kehrt .
An Asian family prepares meat on skewers at a night market .	Eine asiatische Familie bereitet auf einem nächtlichen Markt Fleisch auf Spießen zu .
A black dog swims in the water .	Ein schwarzer Hund schwimmt im Wasser .
Two men , one standing and one on a bicycle are talking outside a building .	Zwei Männer , einer , der steht , und einer auf einem Fahrrad , sprechen vor einem Gebäude miteinander .
The group is watch a cartoon on a small electric device .	Die Gruppe sieht sich auf einem kleinen elektrischen Gerät ein Video an .
A man with a shoulder bag walking in the desert on sand with footprints behind him and the horizon with many stormy clouds .	Ein Mann mit einer Schultertasche geht in der Wüste auf Sand , hinter ihm Fußabdrücken und der Horizont mit vielen Sturmwolken .
A smiling boy runs through the grass .	Ein lächelnder Junge rennt durch das Gras .
A brown horse is standing behind a girl and is sniffing her hair .	Ein braunes Pferd steht hinter einem Mädchen und riecht an ihren Haaren .
Young chefs are arranging food in a kitchen .	Junge Köche arrangieren in einer Küche Speisen .
A boy in blue shirt splashing in water under a dock	Ein Junge in blauem Hemd , der unter einem Dock im Wasser planscht .
A boy splashing through the ocean .	Ein Junge , der durch das Meer planscht .
Workers are serving up customers lined up in front of a Martins famous louisiana sausages vendor tent	Arbeiter bedienen Kunden , die vor einem Verkaufszelt von Martins Famous Lousiana Sausages Schlange stehen .
Two girls are performing tricks on a trampoline .	Zwei Mädchen führen auf einem Trampolin Kunststücke vor .
A girl in a red bikini is jumping into a pool .	Ein Mädchen mit einem roten Bikini springt in ein Schwimmbecken .
A man is pulling a cart covered in chairs .	Ein Mann zieht einen Karren voller Stühle .
A dog with a red collar and its tongue hanging out runs through tall grass .	Ein Hund mit rotem Halsband und heraushängender Zunge rennt durch hohes Gras .
A young boy covering his face while sitting on a trampoline .	Ein Junge sitzt auf einem Trampolin und bedeckt sein Gesicht .
A smiling woman in a purple shirt and white apron wiping her hands on a napkin .	Eine lächelnde Frau in violettem Oberteil und weißer Schürze , die ihre Hände an einer Serviette abwischt .
Person hanging upside down from poles	Eine Person die mit dem Kopf nach unten von Stangen hängt .
A man wearing a gray t @-@ shirt and blue jeans stands ready to hit a golf ball at a driving range .	Ein Mann mit einem grauen T @-@ Shirt und Bluejeans auf einem Driving @-@ Range ist bereit , einen Golfball zu schlagen .
Two puppies run across flat stones in garden area .	Zwei Welpen rennen über flache Steine in einem Gartenbereich .
Dogs running on a cold but sunny morning	Hunde rennen an einem kalten , aber sonnigen Morgen .
An older black woman is operating her electric wheelchair .	Eine ältere schwarze Frau bedient ihren Elektrorollstuhl .
A green tinted hand is being held up in front of a table of people .	Eine grünliche Hand wird vor einem Tisch mit Leuten hochgehalten .
Two men are working on train tracks .	Zwei Männer arbeiten auf Gleisen .
A little girl in an elaborate green and orange dress is chasing after a pink and white balloon figure .	Ein kleines Mädchen in einem ausgefeilten grün @-@ orangefarbenen Kleid rennt einer rosa @-@ weißen Luftballonfigur nach .
These two women are having fun while taking pictures .	Diese beiden Frauen haben Spaß und machen Fotos .
A man in a red shirt is jumping from a large rock formation .	Ein Mann mit einem roten Hemd springt von einem großen Felsen .
Several people are riding on a roller coaster while reacting to going through a loop in various ways .	Mehrere Personen fahren auf einer Achterbahn und reagieren auf unterschiedliche Weise auf einen Looping .
A young boy examines a field of pumpkins , with some already in his wheelbarrow .	Ein Junge durchsucht ein Kürbisfeld , ein paar befinden sich bereits in seiner Schubkarre .
Guy playing banjo in the park as a duck enjoys the music .	Jemand spielt im Park Banjo , und eine Ende genießt die Musik .
The girl in the purple top and shorts , wearing a hat , is laughing .	Das Mädchen im violetten Oberteil , kurzen Hosen und Hut lacht .
Woman in a bikini top is walking on the beach	Eine Frau in einem Bikini @-@ Oberteil geht den Strand entlang .
A man in a dark jacket stands next to a man dressed in brown reaching down into a bag .	Ein Mann in einer dunklen Jacke steht neben einem braun gekleideten Mann , der in eine Tasche greift .
A man on stage performing a concert for people .	Ein Mann auf der Bühne , der für das Publikum ein Konzert gibt .
An ice cream truck is stopped in front of two small apartment buildings .	Ein Eiswagen hält vor zwei kleinen Apartmentgebäuden .
A boy wearing black swimming trunks is standing in a fountain .	Ein Junge mit schwarzer Badehose steht in einem Brunnen .
A young Asian boy leaps for joy into a pool of water , his tongue stuck out for joy .	Ein asiatischer Junge springt vor Freue in eine Wasserpfütze , seine Zunge ist vor Freude herausgestreckt .
Some kids playing near the street .	Ein paar Kinder , die in der Nähe der Straße spielen .
This boy is playing on a playground with tires on it .	Dieser Junge spielt auf einem Spielplatz mit Reifen darauf .
A SCUBA diver swimming deep underwater with a turtle .	Ein Sporttaucher , der tief unter Wasser mit einer Schildkröte schwimmt .
A group of people carry things down a narrow road .	Eine Gruppe von Menschen trägt Dinge eine schmale Straße entlang .
A brown dog is sitting in some long grass .	Ein brauner Hund sitzt in langem Gras .
An African @-@ American baby is crawling on the floor near a table .	Ein afroamerikanisches Baby krabbelt in der Nähe eines Tisches auf dem Boden .
A man walking down the street with a small boy .	Ein Mann , der mit einem kleinen Jungen die Straße entlanggeht .
A man is carrying a trash barrel past a statue of an angel .	Ein Mann trägt einen Mülleimer an einer Engelsstatue vorbei .
A young woman at an open air market buying bread .	Eine junge Frau , die Brot kauft , auf einem Markt im Freien .
A blond girl in a white dress holding a bird in a tree .	Ein blondes Mädchen in einem weißen Kleid , das einen Vogel in einem Baum hält .
Two people go ice skating in a rink .	Zwei Personen , die in einer Eislaufhalle eislaufen .
A little boy and a little girl are lying on a black bench surrounded by adults .	Ein kleiner Junge und ein kleines Mädchen , die umgeben von Erwachsenen auf einer schwarzen Bank liegen .
A boy and a girl playing on the beach .	Ein Junge und ein Mädchen , die am Strand spielen .
An elderly man is wearing overalls and holding a paintbrush .	Ein älterer Mann mit Latzhosen hält einen Pinsel .
An old man is napping on a park bench .	Ein alter Mann macht auf einer Parkbank ein Schläfchen .
A man with a blue baseball cap on is sleeping against a rock .	Ein Mann mit einer blauen Baseballkappe schläft an einen Felsen gelehnt .
A gentleman in traditional garb weaving a blanket in a field .	Ein Herr in traditionellem Outfit , der in einem Feld eine Decke webt .
A man in a yellow shirt vacuums a floor while looking at the camera .	Ein Mann in einem gelbe Hemd saugt einen Fußboden und blickt zur Kamera .
Young African man does work in a field .	Ein junger afrikanischer Mann arbeitet in einem Feld .
A tan dog walks along a grassy path with his long pink tongue hanging out .	Ein lohfarbener Hund , dessen lange rosafarbene Zunge heraushängt , läuft einen Grasweg entlang .
An asian man in a suit on the subway , asleep .	Ein asiatischer Mann in einem Anzug in der U @-@ Bahn , schlafend .
A woman in a white shirt mixing something on the kitchen counter .	Eine Frau in einem weißen Oberteil , die auf der Küchenarbeitsfläche etwas mischt .
People inside of a building with their heads down with a view outside of bikes .	Leute mit gesenkten Köpfen in einem Gebäude , während draußen Motorräder zu sehen sind .
A bike rider wearing a red shirt and black shorts is attended to by city workers .	Städtische Arbeiter kümmern sich um einen Motorradfahrer mit einem roten Hemd und schwarzen Shorts .
A man in dirty jeans on top of a scaffolding .	Ein Mann in schmutzigen Jeans oben auf einem Gerüst .
Two chefs talk together behind a tiled restaurant calendar in a fancy restaurant .	Zwei Köche reden hinter einer gefliesten Theke in einem schicken Restaurant miteinander .
A woman in a white apron prepares various meats on a large grill .	Eine Frau in einer weißen Schürze bereitet auf einem großen Grill verschiedene Fleischsorten zu .
A man in sitting in front of a large Calvin Klein steel advertisement with a long instrument .	Ein Mann , der mit einem langen Instrument vor einer großen Calvin @-@ Klein @-@ Stahlwerbung sitzt .
A man and woman , both wearing shorts , are walking down a sidewalk .	Ein Mann und eine Frau , beide in kurzen Hosen , gehen einen Bürgersteig entlang .
A pair of dancers perform on a red brick street .	Ein Tänzerpaar führt etwas auf einer roten Ziegelstraße auf .
A young boy in a white shirt is holding a wrapper .	Ein Junge in einem weißen Hemd hält ein Einschlagpapier .
A man in a white t @-@ shirt cleaning up debris .	Ein Mann in einem weißen T @-@ Shirt , der Abfälle entsorgt .
Older man in orange jumpsuit holding a water hose .	Ein älterer Mann in einem orangefarbenen Overall , der einen Wasserschlauch hält .
2 boys in the foreground in a karate competition and coaches in background looking on with another coach sitting at table .	2 Jungen im Vordergrund bei einem Karate @-@ Wettkampf und Trainer im Hintergrund , die zusehen , während ein anderer Trainer am Tisch sitzt .
Individuals with balloons participating in a walk .	Personen mit Luftballons , die an einem Spaziergang teilnehmen .
People waiting to cross the street in front of a pharmacy with lit up sign .	Leute , die vor einen Apotheke mit leuchtendem Schild darauf warten , dass sie die Straße überqueren können .
A woman with glasses drinks coffee at a cafe .	Eine Frau mit Brille trinkt in einem Cafe Kaffee .
A man in a bowling alley getting ready to throw the bowling ball down the lane .	Ein Mann in einer Bowlinghalle bereitet sich darauf vor , die Bowlingkugel zu werfen .
A girl removes her eye makeup with an ear swab .	Ein Mädchen entfernt ihr Augen @-@ Makeup mit einem Ohrtupfer .
A large black and white dog is running through a grassy field .	Ein großer schwarz @-@ weißer Hund rennt über eine Wiese .
A man studying for his exams outside a bookstore	Ein Mann lernt vor einer Buchhandlung auf seine Prüfung .
A young man in a red shirt cooking in a frying pan .	Ein junger Mann mit rotem Hemd , der etwas in einer Pfanne zubereitet .
One man kissing another man on the check and both are in white shirts with black vests .	Ein Mann , der einen anderen Mann auf die Wange küsst , und beide tragen weiße Hemden mit schwarzen Westen .
A group of people , dressed the same walking down the street , in a parade .	Eine gleich gekleidete Personengruppe , die bei einer Parade die Straße entlang geht .
People stand on a colorful balcony .	Leute stehen auf einem bunten Balkon .
Two men beating on drums and one man blowing a horn sitting outside .	Zwei Männer schlagen Trommeln und ein Mann bläst ein Horn ; sie sitzen im Freien .
A farmer walks his pet pig down the dirt road .	Ein Bauer geht treibt sein Schwein den Feldweg entlang .
Two girls in bright green boots and a woman are together .	Zwei Mädchen in knallgrünen Stiefeln und eine Frau sind zusammen .
A marketplace with rolling carts selling fruits .	Ein Marktplatz mit fahrbaren Wagen , wo Obst verkauft wird .
A woman with blond @-@ hair and sunglasses sitting at a table and smiling .	Eine Frau mit blonden Haaren und Sonnenbrille , die an einem Tisch sitzt und lächelt .
Three working class African American men are outside .	Drei afroamerikanische Männer aus der Arbeiterklasse sind im Freien .
A little girl is swinging in a baby swing on the playground .	Ein kleines Mädchen schaukelt in einer Babyschaukel auf dem Spielplatz .
A girl standing in the ocean	Ein Mädchen , das im Meer steht
Two children are on the beach and are playing in the wet sand .	Zwei Kinder sind am Strand und spielen im nassen Sand .
A young woman smiling in the distance is enjoying a bubble bath .	Eine junge Frau , die in die Ferne lächelt , genießt ein Schaumbad .
A child wearing black and white swim gear kneeling in shallow water over a plastic yellow boat filled with wet sand .	Ein Kind in schwarz @-@ weißem Badezeug kniet im flachen Wasser über einem gelben Plastikboot , das mit nassem Sand gefüllt ist .
A man is breakdancing on the floor around a crowd of people .	Ein Mann macht auf dem Boden Breakdance , während eine Menschenmenge um ihn herum steht .
A man and woman enjoy a ride down the rapids on a warm day .	Ein Mann und eine Frau genießen an einem warmen Tag eine Fahrt über die Stromschnellen .
A girl doing a split handstand on the beach during the day with a amusement park in the background .	Ein Mädchen , das tagsüber am Strand einen Handstand mit Grätsche macht , während im Hintergrund ein Vergnügungspark zu sehen ist .
A man in an orange shirt is using a scraper in a sifter .	Ein Mann in einem orangefarbenen Hemd benutzt in einer Siebvorrichtung einen Schaber .
Two girls sparring with a red and blue bat while another girl watches .	Zwei Mädchen , die mit einem roten und einem blauen Schläger kämpfen , während ein anderes Mädchen zusieht .
A woman is pushing a young girl in a swing .	Eine Frau gibt einem Mädchen auf einer Schaukel Schwung .
Two boys posing in blue shirts and khaki shorts .	Zwei Jungen posieren in blauen Hemden und khakifarbenen Shorts .
A group of people wait at a platform while a train passes them .	Eine Menschengruppe wartet auf einem Bahnsteig , während ein Zug vorbeifährt .
A small girl playing , on the sidewalk , with a stick .	Ein kleines Mädchen , das auf dem Gehweg mit einem Stock spielt .
A man pushing a hand @-@ truck of boxes is bending over to pick up a pear .	Ein Mann , der einen Handwagen mit Kisten schiebt , beugt sich nach vorne , um eine Birne aufzuheben .
A vendor standing in the window of her shop .	Eine Verkäuferin , die im Fenster ihres Ladens steht .
Several men of Indian origin are conversing and one , in particular , seems very excited about the conversation .	Mehrere Männer indischer Herkunft unterhalten sich , und einer scheint besonders aufgeregt zu sein .
Island woman cooking outside with pineapples and fruit .	Eine Inselbewohnerin , die im Freien mit Ananas und Obst kocht .
A group of people in kilts are playing music while a runner in black runs by .	Eine Gruppe von Kiltträgern spielt Musik , während jemand schwarz gekleidetes vorbei rennt .
A man opening a barbecue oven while holding tongs .	Ein Mann , der einen Grillofen öffnet und eine Zange hält .
The little girl is wearing a denim dress and holding a brown teddy bear .	Das kleine Mädchen trägt ein Jeanskleid und hält einen braunen Teddybär .
A man catches a decent sized fish and is taking it off the hook	Ein Mann fängt einen recht großen Fisch und nimmt ihn vom Haken .
A man with a ponytail and tan tank top sitting on a couch counting on his fingers .	Ein Mann mit Pferdeschwanz und gelbbraunem Tanktop , der auf einer Couch sitzt und etwas an seinen Fingern abzählt .
A man with a green shirt on is working .	Ein Mann mit einem grünen Hemd arbeitet .
Two young attractive women with shorts cross a street of a busy city .	Zwei junge attraktive Frauen mit Shorts überqueren in einer belebten Stadt die Straße .
The man climbs through the rocks and snow .	Der Mann klettert durch Fels und Schnee .
This picture is of a young girl practicing gymnastics in a gym .	Dieses Bild zeigt ein Mädchen , das in einer Turnhalle Gymnastik macht .
Two beige dogs are playing in the snow .	Zwei beige Hunde spielen im Schnee .
A man about to step off the edge of a desert rock formation .	Ein Mann , der dabei ist , einen Schritt von einer Felskante in der Wüste herunter zu machen .
Three women in dresses and headscarves outside .	Drei Frauen mit Kleidern und Kopftüchern im Freien .
A little boy and his bike sit outside the Kuthhoop Hotel .	Ein kleiner Junge sitzt mit seinem Fahrrad vor dem Kuthhoop @-@ Hotel .
The sunshine behind a group of trees on a long rode .	Der Sonnenschein hinter einer Baumgruppe an einer langen Straße .
A man in an orange shirt is taking a picture .	Ein Mann in einem orangefarbenen Hemd macht ein Foto .
A crowd cheers on a baseball team .	Eine Menschenmenge feuert ein Baseballteam an .
A man and a much younger boy , both wearing hats , taking a stroll through nature .	Ein Mann und ein viel jüngerer Junge , beide mit Mützen , spazieren durch die Natur .
Little boy pushing another little boy up the pole .	Ein kleiner Junge , der einen anderen kleinen Jungen den Mast hoch schiebt .
A man with a white shirt and tie is standing on a sidewalk between cement barriers .	Ein Mann mit weißem Hemd und Krawatte steht auf einem Bürgersteig zwischen Betonsperren .
A boy reaches the top of a jungle gym .	Ein Junger erreicht das Oberteil eines Klettergerüsts .
Two people in black vests are standing in front of children in white vests with an American flag between them .	Zwei Personen in schwarzen Hemden stehen vor Kindern in weißen Hemden mit einer amerikanischen Flagge .
A man with swords battling a female with a spear .	Ein Mann mit Schwertern , der gegen eine Frau mit einem Speer kämpft .
Two men in the middle of the action of a fighting match .	Zwei Männer mitten in einem Kampf .
A young man in a white shirt cutting tomatoes .	Ein junger Mann in einem weißen Hemd , der Tomaten schneidet .
A young boy in blue shorts is climbing rocks along the hotel resort beach shore .	Ein Junge in blauen kurzen Hosen erklettert Felsen entlang des Strands einer Hotelanlage .
A man plays saxophone next to a yellow fire hydrant .	Ein Mann spielt neben einem gelben Hydranten Saxophon .
A man in a fish market is cutting swordfish into steaks .	Ein Mann auf einem Fischmarkt schneidet Schwertfisch zu Steaks .
A dog in midair cacthing the red ball .	Ein Hund , der den roten Ball fängt , mitten im Sprung .
Three women dressed in plain clothes are cooking a meal in their kitchen .	Drei einfach gekleidete Frauen bereiten in ihrer Küche eine Mahlzeit zu .
People are walk and running on a bridge sidewalk .	Leute gehen und rennen auf dem Gehweg einer Brücke .
Two young women are walking along a rural path bordered by trees .	Zwei junge Frauen gehen einen baumgesäumten ländlichen Weg entlang .
A young girl on the beach , running toward the water .	Ein Mädchen am Strand , das auf das Wasser zu rennt .
A young boy in a blue shirt and green hat blows up an orange balloon .	Ein junge in einem blauen Hemd und einer grünen Mütze bläst einen orangefarbenen Luftballon auf .
A black and white dog jumping into a pool after tennis balls .	Ein schwarz @-@ weißer Hund , der nach Tennisbällen in einen Pool springt .
Little boy runs the wrong way after hitting the ball in a game of tee ball .	Ein kleiner Junge rennt in die falsche Richtung , nachdem er bei einem Schlagballspiel den Ball geschlagen hat .
A person in a blue shirt is holding a microphone in their hands .	Eine Person mit blauem Hemd hält ein Mikrofon in ihren Händen .
A man in white and red with sunglasses carrying and blowing a very large horn .	Ein Mann mit Sonnenbrille in Weiß und Rot , der ein sehr großes Horn trägt und bläst .
A barefoot redheaded girl jumping over a rail .	Ein barfüßiges rothaariges Mädchen , das über ein Geländer springt .
A woman in shorts throwing a bowling ball down a bowling alley .	Eine Frau in kurzen Hosen , die eine Bowlingkugel auf eine Bowlingbahn wirft .
He is reading a paper and she is looking at him with a smile .	Er liest Zeitung und sie blickt ihn lächelnd an .
A tan dog on a leash running in shallow ocean water .	Ein gelbbrauner Hund an einer Leine , der in flachem Meerwasser rennt .
The boy is jumping in the woods .	Der Junge springt im Wald .
A man and a woman are sitting on the ground and surrounded by boats .	Ein Mann und eine Frau sitzen von Booten umgeben auf dem Boden .
A young boy on the beach running into the ocean waves .	Ein Junge am Strand , der in die Wellen rennt .
A boy in a blue boat tied to a larger boat dumps out a bucket of water .	Ein Junge in einem blauen Boot , das an einem größeren Boot angeleint ist , kippt einen Eimer Wasser aus .
A man walking down a narrow street .	Ein Mann , der eine schmale Straße entlang geht .
A young man rests on an airport seat with a cowboy hat over his face .	Ein junger Mann ruht sich auf einem Flughafensitz mit einem Cowboyhut über dem Gesicht aus .
Children fishing off a bridge	Kinder , die von einer Brücke aus fischen
Man sitting in the shadows on the steps of a building .	Ein Mann , der auf den Stufen eines Gebäudes im Schatten sitzt .
A black and white dog jumping into a pool .	Ein schwarz @-@ weißer Hund , der in einen Pool springt .
A black dog and a white dog race in a grassy field while spectators look on .	Ein schwarzer Hund und ein weißer Hund rennen auf einer Wiese , Zuschauer sehen zu .
A bunch of birds outside of a building .	Ein paar Vögel vor einem Gebäude .
A golfer prepares to take a shot on golf course surrounded by trees .	Ein Golfspieler bereitet auf dem von Bäumen umgebenen Golfplatz einen Schlag vor .
A firefighter extinguishes a fire under the hood of a car .	Ein Feuerwehrmitarbeiter löscht ein Feuer unter der Motorhaube eines Autos .
People gather around a table with many red , white , and blue decorations around in the spacious tent .	Mehrere Personen versammeln sich um einen Tisch mit vielen roten , weißen und blauen Dekorationen im geräumigen Zelt .
A toddler with eggs in a bowl .	Ein Kleinkind mit Eiern in einer Schüssel .
Three teenagers are carrying wood down a street while one of the teenagers is smiling at the camera .	Drei Teenager , die Holz eine Straße entlang tragen , während einer davon in die Kamera lächelt .
A man stands in front of the Gateway Arch .	Ein Mann steht vor dem Gateway Arch .
A young boy covered in ink stands in front of a white door .	Ein tintenverschmierter Junge steht vor einer weißen Tür .
A blond girl is stepping on vertical logs in the sand .	Ein blondes Mädchen geht auf senkrechten Pfählen im Sand .
A young girl with a purple shirt , waters grass .	Ein Mädchen mit einem violetten Oberteil gießt Gras .
The cat looks away from the person next to it .	Die Katze blickt von der Person , die ihr am nächsten ist , weg .
A couple waiting at a crosswalk in a brightly lit city .	Ein Paar wartet an einem Fußgängerübergang in einer hell erleuchteten Stadt .
A person in a yellow shirt stretching on a bridge .	Eine Person in einem gelben Hemd streckt sich auf einer Brücke .
A gut wearing a plaid shirt with a mustache selling fish at a market .	Ein Typ mit kariertem Hemd und Schnauzer , der auf einem Markt Fisch verkauft .
City workers are doing maintenance on a train track .	Städtische Arbeiter verrichten Wartungsarbeiten an einem Gleis .
A child in front of his own reflection turning towards the camera and smiling .	Ein Kind vor seinem eigenen Spiegelbild , das sich zur Kamera dreht und lächelt .
Worker loading handicapped man in wheelchair onto a train .	Ein Arbeiter , der einen behinderten Mann in einem Rollstuhl in einen Zug lädt .
A woman walking in a street with a young boy in front of her , and a running man behind her .	Eine Frau , die eine Straße entlang geht , während ein Junge vor ihr geht und ein Mann hinter ihr rennt .
A woman is looking upset holding a water bottle in front of a wall with writing on it .	Eine Frau sieht aus , als ob sie durcheinander ist , und hält eine Wasserflasche vor einer Wand mit Text .
A group of African boys are looking at water pipes .	Eine Gruppe afrikanischer Jungen blickt auf Wasserrohre .
Three people on grass , one raking leaves , one mowing the lawn , another standing by a garbage bag .	Drei Personen auf dem Gras , eine recht Laub , eine mäht den Rasen , eine andere steht neben einer Mülltüte .
A boy with a yellow shirt and black pants welding something .	Ein Junge mit einem gelben Hemd und schwarzen Hosen schweißt etwas .
Man without a shirt is climbing a rock .	Ein Mann mit nacktem Oberkörper klettert auf einen Felsen .
A girl is winding up to throw a softball .	Ein Mädchen bereitet sich auf einen Softballwurf vor .
A man throws a small child up in the air .	Ein Mann wirft ein kleines Kind in die Luft .
A fluffy white dog is coming out of a blue striped obstacle shute .	Ein flauschiger weißer Hund kommt aus einem blau gestreiften Hindernis @-@ Tunnel .
Two children are sitting on the floor together .	Zwei Kinder sitzen zusammen auf dem Boden .
Young girl carrying camping gear and a stuffed brown dog .	Ein Mädchen trägt Campingausrüstung und einen ausgestopften braunen Hund .
A guy wearing a green shirt is cooking on a campfire	Ein Typ mit einem grünen Hemd kocht an einem Lagerfeuer .
A girl peeks through the leaves on a tree .	Ein Mädchen späht durch die Blätter eines Baumes .
A motorcyclist drives up the side of a green mountain while another bike remains stationary .	Ein Motorradfahrer fährt einen grünen Berg hoch , während ein anderes Motorrad stehen bleibt .
Young boy in climbing harness scaling a climbing wall .	Ein Junge mit Klettergurt steigt eine Kletterwand hoch .
A man wades in the water and watches a waterfall .	Ein Mann wadet im Wasser und beobachtet einen Wasserfall .
A black dog is walking through a stream of water .	Ein schwarzer Hund läuft durch einen Bach .
A man is surfing down a hill of sand .	Ein Mann surft einen Sandhügel hinunter .
A man with red @-@ rimmed glasses stands with arms folded behind a metal grate .	Ein Mann mit einer Brille mit roter Fassung steht mit verschränkten Armen hinter einem Metallgitter .
A dog runs while holding an object in its mouth .	Ein Hund rennt und hält ein Objekt in seinem Maul .
A dog with long hair and a red vest runs in the grass .	Ein Hund mit langem Fell und einer roten Weste rennt im Gras .
Two officers in uniform chatting in a golf cart .	Zwei uniformierte Beamte unterhalten sich in einem Golfwagen .
Younger man in a yellow shirt and tan shorts is moving a dry yard or field with a riding John Deere tractor mover .	Ein junger Mann in einem gelben Hemd und gelbbraunen Hosen gräbt einen trockenen Garten oder ein Feld mit einem Mähtraktor von John Deere um .
The security guard is smiling .	Der Wachmann lächelt .
A long day makes the woman tired and sleepy .	Ein langer Tag macht die Frau müde und schläfrig .
Beautiful brunette woman , draped in purple , blue and a scarlet scarves .	Eine schöne brünette Frau die mit violetten , blauen und scharlachroten Schals drapiert ist .
A small black dog is in the grass .	Ein kleiner schwarzer Hund ist im Gras .
A girl in a gray YMCA sweater looking through a telescope .	Ein Mädchen in einem grauen YMCA @-@ Pullover schaut durch ein Teleskop .
A baby carefully wrapped in a blanket sleeping in an infirmity crib .	Ein Baby , das sorgfältig in eine Decke gepackt ist , schläft in einem Krankenhausbettchen .
A young lady playing guitar on a stage in a park .	Eine junge Dame spielt auf einer Bühne im Park Gitarre .
Three little boys take a bath in a rubber bin on the grass .	Drei Jungen baden in einem Gummieimer auf dem Gras .
Several people are sitting at computer desks in a messy office .	Mehrere Personen sitzen an Computertischen in einem unaufgeräumten Büro .
Girl with half dreadlocks and earmuffs on makes a large bubble	Ein Mädchen mit halben Dreadlocks und Ohrenschützern macht eine große Blase .
Children and women gather outside a building .	Kinder und Frauen versammeln sich vor einem Gebäude .
A man crawls through a playground plastic tube towards a little girl with red @-@ hair .	Ein Mann kriecht durch ein Kunststoffrohr auf einem Spielplatz auf ein kleines rothaariges Mädchen zu .
A balding man is petting a white panda in a zoo .	Ein Mann mit beginnender Glatze streichelt einen Panda in einem Zoo .
A shirtless man in a blue hat and sunglasses runs waist @-@ deep through a large body of water .	Ein Mann mit nacktem Oberkörper , blauer Mütze und Sonnenbrille rennt durch hüfttiefes Wasser eines großen Gewässers .
A man in a black shirt and hat plays guitar .	Ein Mann mit schwarzem Hemd und Hut spielt Gitarre .
A man in a white shirt is plowing a field with two mules .	Ein Mann mit weißem Hemd pflügt ein Feld mit zwei Maultieren .
People playing in the water with a water bike .	Leute spielen im Wasser mit einem Wasserfahrrad .
A blond individual rides a jet ski in water near a mountain range .	Eine blonde Person fährt Wassermotorrad in einem Gewässer in der Nähe eines Gebirges .
Two man are sitting in white room playing guitar .	Zwei Männer sitzen in einem weißen Raum und spielen Gitarre .
Three women walking together down the sidewalk , one is wearing a short white skirt .	Drei Frauen , die zusammen auf dem Gehweg gehen , eine davon trägt einen kurzen weißen Rock .
A boy holds his hands on his head .	Ein Junge hält seine Hände auf seinen Kopf .
A man paint spattered clothing talks on a mobile phone .	Ein Mann mit Farbspritzern auf der Kleidung spricht an einem Handy .
A man in the window of a red big rig truck .	Ein Mann im Fenster eines großen roten Lkw .
A man in an orange raincoat is discussing something with another man wearing work clothes near a sewer manhole .	Ein Mann in einem orangefarbenen Regenmantel bespricht etwas mit einem anderen Mann der Arbeitskleidung trägt , in der Nähe eines Kanalschachts .
A man in a black shirt stands in front of a construction cone .	Ein Mann mit schwarzem Hemd steht vor einem Absperrkegel .
S large man in a blue shirt and shorts leaning against a van in front of a store called " Terrible 's "	Ein großer Mann in blauem Hemd und kurzen Hosen lehnt sich vor einem Laden namens „ Terrible ' s “ gegen einen Lieferwagen .
A videographer and female companion stand by a waterway .	Ein Videomacher und seine weibliche Begleitperson stehen an einem Wasserweg .
A rainbow is formed from a tank spraying water on a street .	Ein Regenbogen bildet sich , als von einem Behälter Wasser auf die Straße spritzt .
The man with the goatee and black shirt is walking along the street .	Der Mann mit dem Spitzbart und dem schwarzen Hemd geht die Straße entlang .
A man in a gray shirt and a hat holding a jackhammer	Ein Mann mit grauem Hemd und Mütze , der einen Bohrhammer hält
Two construction workers talk while looking at a Naval ship .	Zwei Bauarbeiter sprechen und blicken auf ein Schiff der Marine .
A person taking a jump off a rock on a dirt bike .	Eine Person springt von einem Stein auf ein Dirtbike .
A girl playing pool at a pool hall .	Ein Mädchen spielt in einer Billardhalle Billard .
A man climbs up a cliff and reaches an overhang .	Ein Mann klettert eine Felswand hoch und erreicht einen Überhang .
A group of people walking across a rope bridge .	Eine Gruppe geht über einen Seilbrücke .
Young man alone on a white @-@ sand beach enjoys a snack under a beach umbrella .	Ein junger Mann alleine an einem Strand mit weißem Sand isst eine Kleinigkeit unter einem Strandschirm .
A man is performing for a crowd on a tall unicycle .	Ein Mann gibt einer Menschenmenge eine Vorführung auf einem hohen Einrad .
A young boy runs down a field , wearing a name tag .	Ein Junge , der ein Namensschild trägt , rennt über ein Feld .
Earth , water and sky make this a great spot a time out .	Erde , Wasser und Himmel machen diesen Ort zu einem guten Platz , um auszuspannen .
A young baby wearing blue sleepwear has a pacifier in his mouth and is sleeping .	Ein kleines Baby mit blauem Schlafanzug hat einen Schnuller im Mund und schläft .
A man and woman walk down the street together .	Ein Mann und eine Frau gehen zusammen die Straße entlang .
A woman is smiling and reading a newspaper behind a bud light advertisement .	Eine Frau hinter einer Bud Light @-@ Werbung lächelt und liest Zeitung .
Two people look over a terrace wall .	Zwei Leute blicken über eine Terassenmauer .
A lady wearing a bonnet is sitting down with her hands on her lap .	Eine Dame mit einer Haube sitzt mit den Händen im Schoß da .
Three workers are working on a metal roof	Drei Arbeiter arbeiten auf einem Metalldach .
A woman with ripped jeans is laying on the ground with her forearm over her face .	Eine Frau mit gerissenen Jeans liegt mit dem Unterarm über dem Gesicht auf dem Boden .
Woman walking with face painted children while carrying a screaming child .	Eine Frau , die mit Kindern mit Gesichtsbemalung unterwegs ist und ein schreiendes Kind auf dem Arm hat .
A chef with glasses cooks french bread in a giant oven .	Ein Koch mit Brille bereitet in einem riesigen Ofen Baguette zu .
Two people stand outside a wine shop .	Zwei Personen stehen vor einem Weingeschäft .
A man and a woman tak outside of a coffee house .	Ein Mann und eine Frau sprechen vor einem Kaffeehaus miteinander .
A silhouette of a kid playing on a beach .	Eine Silhouette eines Kinds , das an einem Strand spielt .
A man wearing shorts , sandals , and a black shirt is talking on his cellphone .	Ein Mann , der kurze Hosen , Sandalen und ein schwarzes Hemd trägt , spricht auf seinem Handy .
Two men talk in a restaurant kitchen .	Zwei Männer sprechen in einer Restaurantküche miteinander .
A young girl sits on a rock overlooking a large field .	Ein Mädchen sitzt auf einem Felsen und blickt auf ein großes Feld .
A man in a green hat running .	Ein Mann mit einer grünen Mütze , der rennt .
Two males running , one wearing red and white , the other navy blue and black , outside on a cloudy day .	Zwei männliche Personen , die rennen , im Freien , an einem wolkigen Tag ; einer trägt rot und weiß , der andere marineblau und schwarz .
A little boy in a yellow shirt walking on stones .	Ein kleiner Junge in einem gelben Hemd geht auf Steinen .
A crowd of men and women sitting and standing by a we are demanding sign .	Eine aus Männern und Frauen bestehende Menschenmenge sitzt bzw. steht bei einem Schild mit Forderungen .
Five Asian friends posing together for a picture .	Fünf asiatische Freund posieren zusammen für ein Foto .
Four women and one man sitting on the sidewalk with sleeping bags .	Vier Frauen und ein Mann sitzen mit Schlafsäcken auf dem Bürgersteig .
A lot of people bundled up together	Viele warm angezogene Menschen
Three young people are snuggling under a blanket on a sidewalk .	Drei junge Leute kuscheln sich unter eine Decke auf einem Gehweg .
Two people are taking pictures .	Zwei Personen machen Fotos .
Three women and a man in a hat sitting cross legged in a group .	Drei Frauen und ein Mann mit Hut sitzen mit gekreuzten Beinen in einer Gruppe .
There is an Asian girl holding a green sign protesting .	Da ist ein asiatisches Mädchen , das ein grünes Schild hält und protestiert .
A man videotaping a group of people in front of a from new york banner .	Ein Mann , der ein Video von einer Gruppe vor einem „ From New York “ -Banner macht .
People in a courtyard plaza are sitting and standing .	Leute stehen und sitzen in einem Hofgarten .
A man in a lime green shirt waits for the subway while a woman films using her phone .	Ein Mann in einem zitronengelben Hemd wartet auf die U @-@ Bahn , während eine Frau mit ihrem Handy filmt .
Young people in yellow shirts prepare colorful food .	Junge Leute in gelben Hemden bereiten buntes Essen zu .
A woman in a yellow shirt is helping a little girl in a pink shirt .	Eine Frau mit gelbem Oberteil hilft einen kleinen Mädchen mit rosafarbenen Oberteil .
Youngsters are being served green eggs and ham .	Jugendlichen werden grüne Eier mit Speck serviert .
A man in a blue shirt holding a child while holding onto a stroller at a baseball stadium .	Ein Mann mit blauem Hemd in einem Baseballstadion , der ein Kind hält und sich selbst an einen Sportwagen festhält .
Little boys in white karate uniforms performing their martial arts indoors .	Kleine Jungen in weißen Karateuniformen , die in Innenräumen Kampfsport machen .
TWo people walking into a shadow in one direction while another walks in the midst of it .	Zwei Personen , die in eine Richtung in einen Schatten gehen , während eine andere mitten im Schatten geht .
A man , a woman with a child in a stroller on a crowded street .	Ein Mann , eine Frau mit einem Kind im Sportwagen auf einer belebten Straße .
The man is aiming to shoot something while his dog watches .	Der Mann zielt , um zu schießen , während sein Hund zusieht .
A horse is walking beside a boat under a bridge .	Ein Pferd geht unter einer Brücke neben einem Boot .
A young man is sitting at a table with a laptop and earphones .	Ein junger Mann sitzt mit einem Laptop und Kopfhörern an einem Tisch .
A man is playing the banjo at a concert .	Ein Mann spielt auf einem Konzert Banjo .
A lady with a satchel looks at merchandise in a flea market .	Eine Dame mit einer Tasche sieht sich Flohmarktwaren an .
A man is snowboarding over a structure on a snowy hill .	Ein Mann fährt mit einem Snowboard über etwas auf einem verschneiten Hügel .
The brown dog is laying down on a blue sheet .	Der braune Hund liegt auf einem blauen Betttuch .
A man in a black shirt reading a paper .	Ein Mann mit schwarzem Hemd , der eine Zeitung liest .
A man wearing glasses and a blue jacket is smiling while men behind him are cooking on a grill .	Ein Mann mit Brille und blauer Jacke lächelt , während Männer hinter ihm auf einem Grill kochen .
A guy in a leather jacket walking by a corner store .	Ein Mann in Lederjacke , der an einem Eckladen vorbeigeht .
A group of friends stand in front of art they have sprayed for a picture .	Eine Gruppe von Freunden steht vor einem Kunstwerk , das sie für ein Bild gesprüht haben .
The man is doing stunts with his bicycle .	Ein Mann macht mit seinem Fahrrad Kunststücke .
A woman is looking at dressed , headless mannequins in a store display .	Eine Frau blickt auf bekleidete kopflose Puppen in einem Schaufenster .
A kid standing in the middle of a dirt road	Ein Kind , das in der Mitte eines Feldwegs steht
A man in a brown shirt takes a picture of something on the ground in front of him .	Ein Mann mit braunem Hemd macht ein Foto von etwas , das sich vor ihm auf dem Boden befindet .
People sitting in front of other people .	Leute sitzen vor anderen Leuten .
A man wearing a brown t @-@ shirt is talking to a woman wearing a flowered tank top at an outdoor music concert .	Ein Mann mit einem braunen T @-@ Shirt spricht auf einem Open @-@ Air @-@ Konzert zu einer Frau mit einem geblümten Pullunder .
Two girls on the shore watch people in a boat fish .	Zwei Mädchen am Strand beobachten Leute in einem Fischerboot .
Two bicycles are standing behind two people sitting on the grass near a body of water .	Zwei Fahrräder stehen hinter Leuten , die auf dem Gras in der Nähe eines Gewässers sitzen .
Two old men sitting on the dock .	Zwei alte Männer sitzen auf dem Kai .
A man in a suit and two men in orange vests standing around	Ein Mann im Anzug und zwei Männer mit orangefarbenen Westen , die herumstehen
A small child pushes a stroller down the street .	Ein kleines Kind schiebt einen Sportwagen die Straße entlang .
A woman at graduation without a cap on .	Eine Frau bei der Graduierung ohne Hut .
An elder man overlooks a balcony facing a street .	Ein älterer Mann blickt auf einen Balkon , der zu einer Straße hinaus geht .
This woman is smiling and talking on the phone while sitting on a stone wall .	Diese Frau sitzt auf einer Steinmauer , lächelt und spricht am Telefon .
Three dogs in a field looking at something in the grass .	Drei Hunde in einem Feld blicken auf etwas im Gras .
Three children , two girls and one boy , in martial art stances , standing on the hard @-@ wood floor of a large room .	Drei Kinder , zwei Mädchen und ein Junge , stehen in Kampfkunststellungen auf dem Parkettboden eines großen Raums .
A woman sits on a flower pot at a crowded coffee shop .	Eine Frau sitzt in einem überfüllten Cafe auf einem Blumentopf .
A boy stands beside a railing at a go kart track .	Ein Junge steht an einer Go @-@ Kart @-@ Bahn neben einem Geländer .
A white bird is standing on a wooden platform .	Wein weißer Vogel steht auf einer Holzplattform .
There is a guy wearing stilts playing the trombone in front of a mural .	Ein Typ mit Stelzen spielt vor einer Wandmalerei Posaune .
Two young boys , wearing just underwear , climb around a vehicle .	Zwei Jungen in Unterwäsche klettern um ein Fahrzeug herum .
A young blond girl in a pink shirt looks at a large praying mantis on her arm .	Ein blondes Mädchen in rosafarbenem Oberteil blickt auf eine große Gottesanbeterin auf ihrem Arm .
A man dressed in white and with glasses having something to eat .	Ein weiß gekleideter Mann mit Brille isst etwas .
A man is fishing off a beach into a large body of water while a young boy carries a net not too far away .	Ein Mann angelt von einem Strand aus in einem großen Gewässer , während ein Junge in nicht allzu weiter Entfernung ein Netz trägt .
The soldier is standing tall as he observes the passing people .	Der Soldat steht aufrecht , während er die vorbeigehenden Menschen beobachtet .
A young man in a suit standing out from the crowd , at what appears to be an art exhibition .	Ein junger Mann im Anzug fällt bei etwas , das eine Kunstausstellung zu sein scheint , in der Masse auf .
A man preparing fruit below a tree .	Ein Mann , der unter einem Baum Obst zubereitet .
A black dog is coming out of the ocean water on the beach with something in its mouth .	Ein schwarzer Hund , der etwas im Maul hat , kommt aus dem Meerwasser an den Strand .
Two young children are playing on the beach while a man watches .	Zwei kleine Kinder spielen am Strand , ein Mann sieht zu .
A group of people are sitting at a beach watching the Blue Angels .	Eine Gruppe sitzt am Strand und beobachtet die Blue Angels .
Two young ladies play chess in a restaurant .	Zwei junge Damen spielen in einem Restaurant Schach .
A person wearing a long @-@ sleeved white shirt is weaving with yellow thread .	Ein Person mit einem langärmeligen weißen Hemd webt etwas mit einem gelben Faden .
Two women are jogging and three men are walking on a dirt trail .	Zwei Frauen joggen und drei Männer gehen auf einem Feldweg .
These are women members of a musical symphony dressed in black and carrying red flags outside an ornate building .	Dies sind schwarz gekleidete weibliche Mitglieder einer Blaskapelle , die vor einem reich verzierten Gebäude rote Fahnen tragen .
A family of four watches an air show .	Eine vierköpfige Familie betrachtet eine Flugschau .
A person holding a small dog on a leash is bending over and looking through items .	Eine Person , die einen kleinen Hund an der Leine hält , beugt sich nach vor und sieht Sachen durch .
A brown dog carrying a black object .	Ein brauner Hund , der ein schwarzes Objekt trägt .
A frightened little boy being pulled up and out of a pool by his father .	Ein kleiner Junge , der sich fürchtet und von seinem Vater aus einem Schwimmbecken gezogen wird .
A man standing in front of several cliff faces .	Ein Mann , der vor mehreren Felswänden steht .
Two people and a small white dog are playing at the park .	Zwei Personen und ein kleiner weißer Hund spielen im Park .
Two men with long hair are sitting on the ground .	Zwei Männer mit langen Haaren sitzen auf dem Boden .
Members of a brass band look at their sheet music .	Mitglieder einer Blaskapelle blicken auf ihre Noten .
A man is playing a DJ game in an arcade .	Ein Mann in einer Arkade spielt ein DJ @-@ Spiel .
A group of women dressed in black playing musical instruments in front of a large building .	Eine Gruppe schwarz gekleideter Frauen , die vor einem großen Gebäude Musikinstrumente spielen .
One man is sitting on top of a school bus , while another man , wearing a matching shirt , is standing inside .	Ein Mann sitzt auf einem Schulbus , während ein anderer Mann mit passendem Hemd drinnen steht .
Demonstrators waiting for the policemen to hear their grievances against police oppression and brutality .	Demonstranten warten darauf , dass Polizisten ihre Beschwerden gegen Polizeigewalt und Brutalität aufnehmen .
A man wearing a cowboy hat and a gold cross around his neck	Ein Mann mit einem Cowboyhut und einem Goldkreuz um den Hals
A old man and a youth work on starting a tiller .	Ein alter Mann und ein Jugendlicher , die eine Ackerfräse starten .
People wait for their luggage at the airport .	Leute warten am Flughafen auf ihr Gepäck .
A group of people outside after dark facing a waterway .	Eine Menschengruppe nach Einbruch der Dunkelheit im Freien , vor einer Wasserstraße .
Four women participate in synchronized swimming at dark .	Vier Frauen machen Synchronschwimmen im Dunkeln .
A brown dog chases a blond one in the grass .	Ein brauner Hund verfolgt einen blonden Hund im Gras .
A man in a black hat and tan jacket walking across the street .	Ein Mann mit schwarzem Hut und gelbbraunem Jackett überquert die Straße .
A young girl wearing a bikini in an innertube .	Ein Mädchen mit einem Bikini in einem Schlauch .
A man wearing with long hair is sewing a costume .	Ein Mann mit langen Haaren näht ein Kostüm .
A man with a brown t @-@ shirt holds on to a wire while another man looks on .	Ein Mann mit einem braunen T @-@ Shirt hält sich an einem Drahtseil fest , während ein anderer Mann zusieht .
A man in a cape is near a red building .	Ein Mann in einem Cape befindet sich in der Nähe eines roten Gebäudes .
Two men dressed in business casual share a laugh .	Zwei Männer in legerer Geschäftskleidung lachen zusammen .
A bass player in a red shirt is playing while smoking a cigarette .	Ein Bassspieler mit einem roten Hemd spielt , während er eine Zigarette raucht .
A man dressed in black wearing odd headgear swings a staff .	Ein schwarz gekleideter Mann mit einer komischen Kopfbedeckung schwingt einen Stock .
A skinny girl in large boots is standing by the roadside .	Ein mageres Mädchen mit großen Stiefeln steht am Straßenrand .
Two women are standing on a boat looking at the water .	Zwei Frauen stehen auf einem Boot und blicken aufs Wasser .
People looking at pictures on a display .	Leute , die Bilder auf einem Display ansehen .
The small girl is sitting in a harness , strapped to a tether , while others watch .	Das kleine Mädchen sitzt in einem Geschirr , an einem Haltegurt festgebunden , während andere zusehen .
A man wearing a multicolored shirt is holding a megaphone .	Ein Mann mit einem mehrfarbigen Hemd hält ein Megafon .
A young man with dark hair and a beard cooking steaks outside on a small grill .	Ein dunkelhaariger junger Mann mit Bart , der draußen auf einem kleinen Grill Steaks zubereitet .
A uniformed woman holding a camera standing in front of a crowd of spectators .	Eine uniformierte Frau , die eine Kamera hält und vor einer Zuschauermenge steht .
The little boy in red trunks is attempting to catch a soccer ball that is coming towards him .	Der kleine Junge mit den roten Hosen versucht , einen Fußball zu fangen , der auf ihn zu kommt .
Four kids rolling and sliding down a sand dune .	Vier Kinder rollen und rutschen eine Sanddüne herunter .
The small furry white dog is walking in the green grass .	Der pelzige kleine weiße Hund läuft im grünen Gras .
A little girl high @-@ fives a yellow robot .	Ein kleines Mädchen macht High @-@ Five mit einem gelben Roboter .
A person dressed in a blue shirt and jeans looks past the trees to the horizon .	Eine Person mit blauem Hemd und Jeans blickt an den Bäumen vorbei zum Horizont .
Gray and black dogs running away down forest path	Graue und schwarze Hunde rennen einen Waldweg entlang weg .
A woman and a young man are setting at a table in a Mexican restaurant .	Eine Frau und ein junger Mann decken einen Tisch in einem mexikanischen Restaurant .
A rock climber ascends .	Ein Kletterer steigt hoch .
A lady in a black dress is talking to a group of people .	Eine Dame in einem schwarzen Kleid spricht zu einer Gruppe .
Two men are sitting working on their computers .	Zwei sitzende Männer arbeiten an ihren Computern .
A man pouring a wheelbarrow of cement on a sidewalk .	Ein Mann gießt eine Schubkarre Zement auf einen Bürgersteig .
A dog runs along the short at a beach .	Ein Hund rennt am Strand an der Wasserkante entlang .
A young gentlemen with a blue tie talking into a microphone .	Ein junger Herr mit blauer Krawatte , der in ein Mikrofon spricht .
Several younger people walking down a street in heavy clothing .	Mehrere jüngere Personen , die in schwerer Kleidung die Straße entlang gehen .
Women of different ethnicities stand in a room , holding red and yellow darts .	Frauen unterschiedlicher ethnischer Herkunft stehen in einem Raum und halten rote und gelbe Pfeile .
Two dogs shaking off water droplets on a beach .	Zwei Hunde schütteln am Strand Wassertropfen ab .
The male rock climber takes a look over his shoulder at the view of the lake and city .	Der Kletterer blickt über seine Schulter auf den See und die Stadt .
A man rock climbing pauses to calculate his route .	Ein Mann , der klettert , macht Pause , um seine Route zu planen .
A bride and groom are feeding each other wedding cake .	Braut und Bräutigam füttern einander Hochzeitskuchen .
Five workers sitting in front of trucks eating lunch	Fünf Arbeiter , die vor Lkws sitzen und zu Mittag essen
A young male child with curly brown hair , hiding behind a cardboard box in a vegetable vendor 's market .	Ein männliches Kind mit lockigen braunen Haaren , das sich in einem Gemüsemarkt hinter einem Pappkarton versteckt .
A woman is laying in the grass eating something outside the leaning tower of pizza .	Eine Frau liegt vor dem schiefen Turm von Pizza im Gras und isst etwas .
A man and a woman are gambling at a casino and are enjoying themselves .	Ein Mann und eine Frau spielen in einem Kasino und haben Spaß .
Bearded man playing an acoustic guitar	Ein Mann mit Bart , der eine akustische Gitarre spielt
A baby manages to pull himself to his feet with the help of a couch .	Ein Baby schafft e , sich an einer Couch auf die Füße zu ziehen .
A man works on a piece of wood on a spinner .	Ein Mann arbeitet an einem Drehteil an einem Stück Holz .
A man wearing safety gear operates a machine with tents on the background .	Ein Mann mit Sicherheitsausrüstung bedient eine Maschine , im Hintergrund stehen Zelte .
A woman , dressed in a yellow blouse and black panties , is playing beach volleyball .	Eine Frau in gelber Bluse und schwarzem Schlüpfer spielt Beachvolleyball .
A girl smiles as she runs across the white sandy beach in her swimsuit .	Ein Mädchen rennt lächelnd in ihrem Schwimmanzug über den weißen Sandstrand .